3*
100*1*1*1*20*70*0
101*1*1*1*20*70*0
102*1*1*1*20*70*0
103*1*1*3*20*70*0
104*1*1*3*20*70*0
105*1*1*3*20*70*0
106*1*1*1*20*70*0
107*1*1*1*20*70*0
108*1*1*1*20*70*0
200*1*3*1*20*80*0
201*1*3*1*20*80*0
202*1*3*1*20*80*0
203*1*3*3*20*60*0
204*1*3*3*20*60*0
205*1*3*3*20*60*0
206*1*3*1*20*80*0
207*1*3*1*20*80*0
208*1*3*1*20*80*0
209*1*3*2*20*100*0
210*1*3*2*20*100*0
211*1*3*2*20*100*0
300*1*2*1*20*70*0
301*1*2*1*20*70*0
302*1*2*1*20*70*0
303*1*2*3*20*50*0
304*1*2*3*20*50*0
305*1*2*3*20*50*0
306*1*2*1*20*70*0
307*1*2*1*20*70*0
308*1*2*1*20*70*0
309*1*2*2*20*90*0
310*1*2*2*20*90*0
311*1*2*2*20*90*0
400*1*4*1*20*90*0
401*1*4*1*20*90*0
402*1*4*1*20*90*0
403*1*4*3*20*70*0
404*1*4*3*20*70*0
405*1*4*3*20*70*0
406*1*4*1*20*90*0
407*1*4*1*20*90*0
408*1*4*1*20*90*0
409*1*4*2*20*110*0
410*1*4*2*20*110*0
411*1*4*2*20*110*0
500*1*5*1*20*100*0
501*1*5*1*20*100*0
502*1*5*1*20*100*0
503*1*5*3*20*80*0
504*1*5*3*20*80*0
505*1*5*3*20*80*0
506*1*5*1*20*100*0
507*1*5*1*20*100*0
508*1*5*1*20*100*0
509*1*5*2*20*120*0
510*1*5*2*20*120*0
511*1*5*2*20*120*0
600*2*1*1*25*120*0
601*2*1*1*25*120*0
602*2*1*1*25*120*0
603*2*1*3*25*100*0
604*2*1*3*25*100*0
605*2*1*3*25*100*0
606*2*1*1*25*120*0
607*2*1*1*25*120*0
608*2*1*1*25*120*0
609*2*1*2*25*140*0
610*2*1*2*25*140*0
611*2*1*2*25*140*0
700*2*2*1*25*130*0
701*2*2*1*25*130*0
702*2*2*1*25*130*0
703*2*2*3*25*110*0
704*2*2*3*25*110*0
705*2*2*3*25*110*0
706*2*2*1*25*130*0
707*2*2*1*25*130*0
708*2*2*1*25*130*0
709*2*2*2*25*150*0
710*2*2*2*25*150*0
711*2*2*2*25*150*0
800*2*3*1*25*140*0
801*2*3*1*25*140*0
802*2*3*1*25*140*0
803*2*3*3*25*120*0
804*2*3*3*25*120*0
805*2*3*3*25*120*0
806*2*3*1*25*140*0
807*2*3*1*25*140*0
808*2*3*1*25*140*0
809*2*3*2*25*160*0
810*2*3*2*25*160*0
811*2*3*2*25*160*0
900*2*4*1*25*150*0
901*2*4*1*25*150*0
902*2*4*1*25*150*0
903*2*4*3*25*130*0
904*2*4*3*25*130*0
905*2*4*3*25*130*0
906*2*4*1*25*150*0
907*2*4*1*25*150*0
908*2*4*1*25*150*0
909*2*4*2*25*170*0
910*2*4*2*25*170*0
911*2*4*2*25*170*0
1*3*1*1*40*200*0
2*3*2*1*40*220*0
3*3*3*2*40*240*0
4*3*4*3*40*260*0
4*
100*2*1*1*25*130*0
101*2*1*1*25*130*0
102*2*1*1*25*130*0
103*2*1*3*25*130*0
104*2*1*3*25*130*0
105*2*1*3*25*130*0
106*2*1*1*25*130*0
107*2*1*1*25*130*0
108*2*1*1*25*130*0
200*2*3*1*25*140*0
201*2*3*1*25*140*0
202*2*3*1*25*140*0
203*2*3*3*25*120*0
204*2*3*3*25*120*0
205*2*3*3*25*120*0
206*2*3*1*25*140*0
207*2*3*1*25*140*0
208*2*3*1*25*140*0
209*2*3*2*25*160*0
210*2*3*2*25*160*0
211*2*3*2*25*160*0
300*2*2*1*25*130*0
301*2*2*1*25*130*0
302*2*2*1*25*130*0
303*2*2*3*25*110*0
304*2*2*3*25*110*0
305*2*2*3*25*110*0
306*2*2*1*25*130*0
307*2*2*1*25*130*0
308*2*2*1*25*130*0
309*2*2*2*25*150*0
310*2*2*2*25*150*0
311*2*2*2*25*150*0
400*2*4*1*25*150*0
401*2*4*1*25*150*0
402*2*4*1*25*150*0
403*2*4*3*25*130*0
404*2*4*3*25*130*0
405*2*4*3*25*130*0
406*2*4*1*25*150*0
407*2*4*1*25*150*0
408*2*4*1*25*150*0
409*2*4*2*25*170*0
410*2*4*2*25*170*0
411*2*4*2*25*170*0
500*2*5*1*25*160*0
501*2*5*1*25*160*0
502*2*5*1*25*160*0
503*2*5*3*25*140*0
504*2*5*3*25*140*0
505*2*5*3*25*140*0
506*2*5*1*25*160*0
507*2*5*1*25*160*0
508*2*5*1*25*160*0
509*2*5*2*25*180*0
510*2*5*2*25*180*0
511*2*5*2*25*180*0
600*3*1*1*40*180*0
601*3*1*1*40*180*0
602*3*1*1*40*180*0
603*3*1*3*40*160*0
604*3*1*3*40*160*0
605*3*1*3*40*160*0
606*3*1*1*40*180*0
607*3*1*1*40*180*0
608*3*1*1*40*180*0
609*3*1*2*40*200*0
610*3*1*2*40*200*0
611*3*1*2*40*200*0
700*3*2*1*40*190*0
701*3*2*1*40*190*0
702*3*2*1*40*190*0
703*3*2*3*40*170*0
704*3*2*3*40*170*0
705*3*2*3*40*170*0
706*3*2*1*40*190*0
707*3*2*1*40*190*0
708*3*2*1*40*190*0
709*3*2*2*40*210*0
710*3*2*2*40*210*0
711*3*2*2*40*210*0
800*3*3*1*40*200*0
801*3*3*1*40*200*0
802*3*3*1*40*200*0
803*3*3*3*40*180*0
804*3*3*3*40*180*0
805*3*3*3*40*180*0
806*3*3*1*40*200*0
807*3*3*1*40*200*0
808*3*3*1*40*200*0
809*3*3*2*40*220*0
810*3*3*2*40*220*0
811*3*3*2*40*220*0
900*3*4*1*40*210*0
901*3*4*1*40*210*0
902*3*4*1*40*210*0
903*3*4*3*40*190*0
904*3*4*3*40*190*0
905*3*4*3*40*190*0
906*3*4*1*40*210*0
907*3*4*1*40*210*0
908*3*4*1*40*210*0
909*3*4*2*40*230*0
910*3*4*2*40*230*0
911*3*4*2*40*230*0
1*4*1*1*100*500*0
2*4*2*1*100*520*0
3*4*3*2*100*540*0
4*4*4*3*100*560*0
5*
100*3*1*1*40*190*0
101*3*1*1*40*190*0
102*3*1*1*40*190*0
103*3*1*3*40*190*0
104*3*1*3*40*190*0
105*3*1*3*40*190*0
106*3*1*1*40*190*0
107*3*1*1*40*190*0
108*3*1*1*40*190*0
200*3*3*1*40*200*0
201*3*3*1*40*200*0
202*3*3*1*40*200*0
203*3*3*3*40*180*0
204*3*3*3*40*180*0
205*3*3*3*40*180*0
206*3*3*1*40*200*0
207*3*3*1*40*200*0
208*3*3*1*40*200*0
209*3*3*3*40*220*0
210*3*3*3*40*220*0
211*3*3*3*40*220*0
300*3*2*1*40*190*0
301*3*2*1*40*190*0
302*3*2*1*40*190*0
303*3*2*3*40*170*0
304*3*2*3*40*170*0
305*3*2*3*40*170*0
306*3*2*1*40*190*0
307*3*2*1*40*190*0
308*3*2*1*40*190*0
309*3*2*3*40*210*0
310*3*2*3*40*210*0
311*3*2*3*40*210*0
400*3*4*1*40*210*0
401*3*4*1*40*210*0
402*3*4*1*40*210*0
403*3*4*3*40*190*0
404*3*4*3*40*190*0
405*3*4*3*40*190*0
406*3*4*1*40*210*0
407*3*4*1*40*210*0
408*3*4*1*40*210*0
409*3*4*3*40*230*0
410*3*4*3*40*230*0
411*3*4*3*40*230*0
500*3*5*1*40*220*0
501*3*5*1*40*220*0
502*3*5*1*40*220*0
503*3*5*3*40*200*0
504*3*5*3*40*200*0
505*3*5*3*40*200*0
506*3*5*1*40*220*0
507*3*5*1*40*220*0
508*3*5*1*40*220*0
509*3*5*3*40*240*0
510*3*5*3*40*240*0
511*3*5*3*40*240*0
600*4*1*1*100*480*0
601*4*1*1*100*480*0
602*4*1*1*100*480*0
603*4*1*4*100*460*0
604*4*1*4*100*460*0
605*4*1*4*100*460*0
606*4*1*1*100*480*0
607*4*1*1*100*480*0
608*4*1*1*100*480*0
609*4*1*2*100*500*0
610*4*1*2*100*500*0
611*4*1*2*100*500*0
700*4*2*1*100*490*0
701*4*2*1*100*490*0
702*4*2*1*100*490*0
703*4*2*4*100*470*0
704*4*2*4*100*470*0
705*4*2*4*100*470*0
706*4*2*1*100*490*0
707*4*2*1*100*490*0
708*4*2*1*100*490*0
709*4*2*2*100*510*0
710*4*2*2*100*510*0
711*4*2*2*100*510*0
800*4*3*1*100*500*0
801*4*3*1*100*500*0
802*4*3*1*100*500*0
803*4*3*4*100*480*0
804*4*3*4*100*480*0
805*4*3*4*100*480*0
806*4*3*1*100*500*0
807*4*3*1*100*500*0
808*4*3*1*100*500*0
809*4*3*2*100*520*0
810*4*3*2*100*520*0
811*4*3*2*100*520*0
900*4*4*1*100*510*0
901*4*4*1*100*510*0
902*4*4*1*100*510*0
903*4*4*4*100*490*0
904*4*4*4*100*490*0
905*4*4*4*100*490*0
906*4*4*1*100*510*0
907*4*4*1*100*510*0
908*4*4*1*100*510*0
909*4*4*2*100*530*0
910*4*4*2*100*530*0
911*4*4*2*100*530*0
1*5*1*1*140*700*0
2*5*2*1*140*720*0
3*5*3*2*140*740*0
4*5*4*3*140*760*0